PSG Summary for HelloWorld
Nodes: 1540
Edges: 1712
Entry Points: 1
Symbols: 249

Entry Points:
  - HelloWorld.main (Binding:EntryPoint)

Symbol Table:
  (%): Microsoft.FSharp.Core.Operators.(%)
  (&&&): Microsoft.FSharp.Core.Operators.(&&&)
  (*): Microsoft.FSharp.Core.Operators.(*)
  (+): Microsoft.FSharp.Core.Operators.(+)
  (-): Microsoft.FSharp.Core.Operators.(-)
  (/): Microsoft.FSharp.Core.Operators.(/)
  (<): Microsoft.FSharp.Core.Operators.(<)
  (<<<): Microsoft.FSharp.Core.Operators.(<<<)
  (<=): Microsoft.FSharp.Core.Operators.(<=)
  (=): Microsoft.FSharp.Core.Operators.(=)
  (>): Microsoft.FSharp.Core.Operators.(>)
  (>=): Microsoft.FSharp.Core.Operators.(>=)
  (>>>): Microsoft.FSharp.Core.Operators.(>>>)
  (^^^): Microsoft.FSharp.Core.Operators.(^^^)
  (|>): Microsoft.FSharp.Core.Operators.(|>)
  (|Some|None|): Alloy.Core.(|Some|None|)
  (|||): Microsoft.FSharp.Core.Operators.(|||)
  (~~~): Microsoft.FSharp.Core.Operators.(~~~)
  Alloy: Alloy
  Array: Array
  AutoOpenAttribute: Microsoft.FSharp.Core.AutoOpenAttribute
  Dispose: Alloy.Core.IDisposable.Dispose
  E: Alloy.Math.Constants.E
  EXPONENT_BIAS: Alloy.Math.NativeMath.FloatConstants.EXPONENT_BIAS
  EXPONENT_MASK: Alloy.Math.NativeMath.FloatConstants.EXPONENT_MASK
  EXPONENT_SHIFT: Alloy.Math.NativeMath.FloatConstants.EXPONENT_SHIFT
  Error: Alloy.Core.Result<_,_>.Error
  FSharp: Microsoft.FSharp
  Format: Format
  Item: Alloy.Memory.ReadOnlySpan.Item
  Length: Alloy.Memory.Span.Length
  List: List
  LiteralAttribute: Microsoft.FSharp.Core.LiteralAttribute
  Ln10: Alloy.Math.Constants.Ln10
  Ln2: Alloy.Math.Constants.Ln2
  MANTISSA_BITS: Alloy.Math.NativeMath.FloatConstants.MANTISSA_BITS
  MANTISSA_MASK: Alloy.Math.NativeMath.FloatConstants.MANTISSA_MASK
  Math: Math
  Memory: Memory
  NativeMath: NativeMath
  NativePtr: NativePtr
  None: None
  Ok: Alloy.Core.Result<_,_>.Ok
  One: Alloy.Math.NumericCapabilities.Float32Numeric.One
  Pi: Alloy.Math.Constants.Pi
  Prompt: Alloy.Console.Prompt
  ReadLine: Alloy.Console.ReadLine
  ReferenceEquals: System.Object.ReferenceEquals
  SIGN_MASK: Alloy.Math.NativeMath.FloatConstants.SIGN_MASK
  STDERR_FILENO: Alloy.Console.STDERR_FILENO
  STDIN_FILENO: Alloy.Console.STDIN_FILENO
  STDOUT_FILENO: Alloy.Console.STDOUT_FILENO
  Some: Some
  Sqrt2: Alloy.Math.Constants.Sqrt2
  Sqrt3: Alloy.Math.Constants.Sqrt3
  StackBuffer: Alloy.Memory.StackBuffer
  T: T
  Text: Text
  ValueNone: Microsoft.FSharp.Core.ValueOption<_>.ValueNone
  ValueSome: Microsoft.FSharp.Core.ValueOption<_>.ValueSome
  Write: Alloy.Console.Write
  WriteError: Alloy.Console.WriteError
  WriteErrorLine: Alloy.Console.WriteErrorLine
  WriteLine: Alloy.Console.WriteLine
  ``.ctor``: Alloy.Memory.ReadOnlySpan
  ``not``: Microsoft.FSharp.Core.Operators.``not``
  a: a
  abs: Alloy.Math.Functions.abs
  acc: acc
  add: Alloy.Text.TextOperations.add
  addToPtr: Alloy.Memory.NativeOperations.addToPtr
  allocOnStack: Alloy.Memory.NativeOperations.allocOnStack
  apply: Alloy.Core.Result.apply
  arg: arg
  array: array
  asReadOnlySpan: Alloy.Memory.ReadOnlySpan.asReadOnlySpan
  asSpan: Alloy.Memory.NativeBuffer.asSpan
  asSpanSlice: Alloy.Memory.NativeBuffer.asSpanSlice
  average: Alloy.Math.Functions.average
  b: b
  bimap: Alloy.Core.Result.bimap
  bind: Alloy.Core.Result.bind
  bitsToDouble: Alloy.Math.NativeMath.bitsToDouble
  bitsToFloat: Alloy.Math.NativeMath.bitsToFloat
  box: Microsoft.FSharp.Core.Operators.box
  buffer: buffer
  bytesToString: Alloy.Text.UTF8.bytesToString
  ceiling: Alloy.Math.NativeMath.ceiling
  ceilingf: Alloy.Math.NativeMath.ceilingf
  choice: Alloy.Core.Result.choice
  choose: Alloy.Core.choose
  concat: Alloy.Text.String.concat
  condition: condition
  contains: Alloy.Core.Result.contains
  cos: Alloy.Math.Functions.cos
  cosFloat: Alloy.Math.Functions.cosFloat
  count: Alloy.Core.Result.count
  def: def
  defaultValue: Alloy.Core.Result.defaultValue
  defaultWith: Alloy.Core.Result.defaultWith
  default_value: Alloy.Core.default_value
  default_with: Alloy.Core.default_with
  defaultof: Microsoft.FSharp.Core.Operators.Unchecked.defaultof
  destination: destination
  divide: Alloy.Math.Functions.divide
  doubleToBits: Alloy.Math.NativeMath.doubleToBits
  e: e
  endsWith: Alloy.Text.String.endsWith
  eprintf: Alloy.Console.eprintf
  eprintfn: Alloy.Console.eprintfn
  equals: Alloy.Math.Functions.equals
  error: error
  f: f
  fResult: fResult
  failwith: Microsoft.FSharp.Core.Operators.failwith
  filter: Alloy.Core.filter
  find: Alloy.Core.find
  flatten: Alloy.Core.Result.flatten
  floatToBits: Alloy.Math.NativeMath.floatToBits
  floor: Alloy.Math.NativeMath.floor
  floorf: Alloy.Math.NativeMath.floorf
  fold: Microsoft.FSharp.Collections.List.fold
  format: format
  formatInt: Alloy.Console.Format.formatInt
  formatted: formatted
  found: found
  fromPointer: Alloy.Memory.Span.fromPointer
  fromPointerReadOnly: Alloy.Memory.ReadOnlySpan.fromPointerReadOnly
  get: Alloy.Memory.ReadOnlySpan.get
  getError: Alloy.Core.Result.getError
  getFromPtr: Alloy.Memory.NativeOperations.getFromPtr
  getLength: Alloy.Memory.NativeBuffer.getLength
  getPointer: Alloy.Memory.NativeBuffer.getPointer
  greaterThan: Alloy.Math.Functions.greaterThan
  greaterThanOrEqual: Alloy.Math.Functions.greaterThanOrEqual
  i: i
  ignore: Microsoft.FSharp.Core.Operators.ignore
  increment: Alloy.Text.TextOperations.increment
  init: Microsoft.FSharp.Collections.Array.init
  innerResult: innerResult
  int: Microsoft.FSharp.Core.int
  intToString: Alloy.Text.Format.intToString
  isEmpty: Alloy.Text.String.isEmpty
  isError: Alloy.Core.Result.isError
  isNotEmpty: Alloy.Text.String.isNotEmpty
  isNull: Alloy.Text.TextOperations.isNull
  isOk: Alloy.Core.Result.isOk
  is_none: Alloy.Core.is_none
  is_some: Alloy.Core.is_some
  iter: Alloy.Core.Result.iter
  iteri: Alloy.Core.iteri
  j: j
  len: len
  length: Alloy.Text.String.length
  lessThan: Alloy.Math.Functions.lessThan
  lessThanOrEqual: Alloy.Math.Functions.lessThanOrEqual
  main: HelloWorld.main
  map: Alloy.Core.Result.map
  mapError: mapError
  mapOk: mapOk
  mapSpan: Alloy.Memory.Span.mapSpan
  mapi: Alloy.Core.mapi
  max: Alloy.Math.Functions.max
  message: message
  min: Alloy.Math.Functions.min
  minLength: minLength
  modulo: Alloy.Math.Functions.modulo
  multiply: Alloy.Math.Functions.multiply
  name: name
  nativeptr: Microsoft.FSharp.Core.nativeptr
  none: Alloy.Core.none
  not_equals: Alloy.Core.not_equals
  ofBool: Alloy.Core.Result.ofBool
  ofOption: Alloy.Core.Result.ofOption
  onError: onError
  onOk: onOk
  one: Alloy.Math.Generic.one
  opt: opt
  orElse: Alloy.Core.Result.orElse
  pointer: pointer
  pos: pos
  power: Alloy.Math.Functions.power
  print: Alloy.Core.print
  printf: Alloy.Console.printf
  printfn: Alloy.Console.printfn
  product: Alloy.Math.Functions.product
  readBytes: Alloy.Console.readBytes
  readInto: Alloy.Console.readInto
  readLine: Alloy.Console.readLine
  reinterpretBits: Alloy.Math.BitOperations.reinterpretBits
  replace: Alloy.Text.String.replace
  result: result
  result1: result1
  result2: result2
  results: results
  round: Alloy.Math.NativeMath.round
  roundf: Alloy.Math.NativeMath.roundf
  s: s
  sequence: Alloy.Core.Result.sequence
  set: Alloy.Memory.Span.set
  setAtPtr: Alloy.Memory.NativeOperations.setAtPtr
  sign: Alloy.Math.Functions.sign
  sin: Alloy.Math.Functions.sin
  sinFloat: Alloy.Math.Functions.sinFloat
  sliceReadOnlySpan: Alloy.Memory.ReadOnlySpan.sliceReadOnlySpan
  sliceSpan: Alloy.Memory.Span.sliceSpan
  some: Alloy.Core.some
  span: span
  spanToString: Alloy.Text.UTF8.spanToString
  sprintf: Alloy.Console.sprintf
  sprintf1: Alloy.Text.Format.sprintf1
  sqrt: Alloy.Math.Functions.sqrt
  sqrtFloat: Alloy.Math.Functions.sqrtFloat
  sqrtFloat32: Alloy.Math.Functions.sqrtFloat32
  stackBuffer: Alloy.Memory.stackBuffer
  stackalloc: Microsoft.FSharp.NativeInterop.NativePtr.stackalloc
  start: start
  startsWith: Alloy.Text.String.startsWith
  state: state
  str: str
  string: Microsoft.FSharp.Core.string
  stringToBytes: Alloy.Text.UTF8.stringToBytes
  subtract: Alloy.Math.Functions.subtract
  sum: Alloy.Math.Functions.sum
  tan: Alloy.Math.Functions.tan
  tempBuffer: tempBuffer
  toOption: Alloy.Core.Result.toOption
  traverse: Alloy.Core.Result.traverse
  tryCharAt: Alloy.Text.String.tryCharAt
  tryFind: Alloy.Core.tryFind
  tryWith: Alloy.Core.Result.tryWith
  use': Alloy.Core.Resource.use'
  v: v
  value: value
  writeBytes: Alloy.Console.writeBytes
  writeChar: Alloy.Console.writeChar
  writeCharTo: Alloy.Console.writeCharTo
  writeErrorLine: Alloy.Console.writeErrorLine
  writeLine: Alloy.Console.writeLine
  writeNewLine: Alloy.Console.writeNewLine
  writeNewLineTo: Alloy.Console.writeNewLineTo
  writeString: Alloy.Console.writeString
  writeStringToFd: Alloy.Console.writeStringToFd
  x: x
  xResult: xResult
  y: y
  zero: Alloy.Math.Generic.zero
  zeroCreate: Microsoft.FSharp.Collections.Array.zeroCreate
  zip: Alloy.Core.Result.zip
